{
  "EGLC": {
    "arrivals": [
      "LG4591",
      "LG4591",
      "EN8770",
      "BA8490",
      "AZ218",
      "BA8450",
      "BA8721",
      "KL979",
      "BA8751",
      "GR400"
    ],
    "departures": [
      "BA4460",
      "BA8483",
      "BA8763",
      "BA2221",
      "BA8481",
      "BA8463",
      "LG4592"
    ]
  },
  "KLGA": {
    "arrivals": [
      "LG4591",
      "LG4591",
      "EN8770",
      "BA8490",
      "AZ218",
      "BA8450",
      "BA8721",
      "KL979",
      "BA8751",
      "GR400"
    ],
    "departures": [
      "BA4460",
      "BA8483",
      "BA8763",
      "BA2221",
      "BA8481",
      "BA8463",
      "LG4592"
    ]
  },
  "ZSPD": {
    "arrivals": [
      "LG4591",
      "LG4591",
      "EN8770",
      "BA8490",
      "AZ218",
      "BA8450",
      "BA8721",
      "KL979",
      "BA8751",
      "GR400"
    ],
    "departures": [
      "BA4460",
      "BA8483",
      "BA8763",
      "BA2221",
      "BA8481",
      "BA8463",
      "LG4592"
    ]
  },
  "ZPDL": {
    "arrivals": [
      "LG4591",
      "LG4591",
      "EN8770",
      "BA8490",
      "AZ218",
      "BA8450",
      "BA8721",
      "KL979",
      "BA8751",
      "GR400"
    ],
    "departures": [
      "BA4460",
      "BA8483",
      "BA8763",
      "BA2221",
      "BA8481",
      "BA8463",
      "LG4592"
    ]
  },
  "ZBAA": {
    "arrivals": [
      "LG4591",
      "LG4591",
      "EN8770",
      "BA8490",
      "AZ218",
      "BA8450",
      "BA8721",
      "KL979",
      "BA8751",
      "GR400"
    ],
    "departures": [
      "BA4460",
      "BA8483",
      "BA8763",
      "BA2221",
      "BA8481",
      "BA8463",
      "LG4592"
    ]
  },
  "A1": {
    "arrivals": [
      "LG4591",
      "LG4591",
      "EN8770",
      "BA8490",
      "AZ218",
      "BA8450",
      "BA8721",
      "KL979",
      "BA8751",
      "GR400"
    ],
    "departures": [
      "BA4460",
      "BA8483",
      "BA8763",
      "BA2221",
      "BA8481",
      "BA8463",
      "LG4592"
    ]
  },
  "A2": {
    "arrivals": [
      "LG4591",
      "LG4591",
      "EN8770",
      "BA8490",
      "AZ218",
      "BA8450",
      "BA8721",
      "KL979",
      "BA8751",
      "GR400"
    ],
    "departures": [
      "BA4460",
      "BA8483",
      "BA8763",
      "BA2221",
      "BA8481",
      "BA8463",
      "LG4592"
    ]
  },
  "ZUUU": {
    "arrivals": [
      "LG4591",
      "LG4591",
      "EN8770",
      "BA8490",
      "AZ218",
      "BA8450",
      "BA8721",
      "KL979",
      "BA8751",
      "GR400"
    ],
    "departures": [
      "BA4460",
      "BA8483",
      "BA8763",
      "BA2221",
      "BA8481",
      "BA8463",
      "LG4592"
    ]
  },
  "CYVR": {
    "arrivals": [
      "LG4591",
      "LG4591",
      "EN8770",
      "BA8490",
      "AZ218",
      "BA8450",
      "BA8721",
      "KL979",
      "BA8751",
      "GR400"
    ],
    "departures": [
      "BA4460",
      "BA8483",
      "BA8763",
      "BA2221",
      "BA8481",
      "BA8463",
      "LG4592"
    ]
  },
  "A3": {
    "arrivals": [
      "LG4591",
      "LG4591",
      "EN8770",
      "BA8490",
      "AZ218",
      "BA8450",
      "BA8721",
      "KL979",
      "BA8751",
      "GR400"
    ],
    "departures": [
      "BA4460",
      "BA8483",
      "BA8763",
      "BA2221",
      "BA8481",
      "BA8463",
      "LG4592"
    ]
  },
  "A4": {
    "arrivals": [
      "LG4591",
      "LG4591",
      "EN8770",
      "BA8490",
      "AZ218",
      "BA8450",
      "BA8721",
      "KL979",
      "BA8751",
      "GR400"
    ],
    "departures": [
      "BA4460",
      "BA8483",
      "BA8763",
      "BA2221",
      "BA8481",
      "BA8463",
      "LG4592"
    ]
  },
  "A5": {
    "arrivals": [
      "LG4591",
      "LG4591",
      "EN8770",
      "BA8490",
      "AZ218",
      "BA8450",
      "BA8721",
      "KL979",
      "BA8751",
      "GR400"
    ],
    "departures": [
      "BA4460",
      "BA8483",
      "BA8763",
      "BA2221",
      "BA8481",
      "BA8463",
      "LG4592"
    ]
  }
}
